11111111111111111111
1111C001000000001111
11C0001000C000001CE1
1P000100111100000101
11C10001C00000010001
11111111111111111111